%%%%%%%%%%%%%%%%%%%%%%%%%%%%%%%%%%%%%%%%%%%%%%%%%%%%%%%%%%%%%%%%%%%%%%%%%%
%       % % %           %   %     % %%       % % %           %   %     % %
% %%%%%%% % %%% % %%% %%% %%%%%%% % %% %%%%%%% % %%% % %%% %%% %%%%%%% % %
%       %       % %     %     % %   %%       %       % %     %     % %   %
%%%%% %%%%% %%% % % % %%% %%%%% % %%%%%%%% %%%%% %%% % % % %%% %%%%% % %%%
%   % % % %   % % % %   % %   % %   %%   % % % %   % % % %   % %   % %   %
% %%% % % % %%% %%%%% %%% % %%% %%% %% %%% % % % %%% %%%%% %%% % %%% %%% %
%       %     %   %   %     % % %   %%       %     %   %   %     % % %   %
%%% %%%%%%%%% %%%%%%% %%% %%% % % % %%%% %%%%%%%%% %%%%%%% %%% %%% % % % %
%             %       % %   %     % %%             %       % %   %     % %
% % %%%%% % %%% % % %%% % %%% %%% % %% % %%%%% % %%% % % %%% % %%% %%% % %
% % %     % % % % %     %   % % % % %% % %     % % % % %     %   % % % % %
% % % %%%%%%% % %%%%%%%%% %%% % %%% %% % % %%%%%%% % %%%%%%%%% %%% % %%% %
% % % %     %   %     %     %   %   %% % % %     %   %     %     %   %   %
%%% %%% % %%%%% %%%%% %%% %%% %%%%% %%%% %%% % %%%%% %%%%% %%% %%% %%%%% %
%     % % %     % %     % %   % % % %%     % % %     % %     % %   % % % %
% % % % % %%% %%% %%% %%% % % % % % %% % % % % %%% %%% %%% %%% % % % % % %
% % % % %                 % % %     %% % % % %                 % % %     %
%%% %%%%%%% % % %%%%% %%% % %%% %%%%%%%% %%%%%%% % % %%%%% %%% % %%% %%%%%
%       % % % %     %   %     % %   %%       % % % %     %   %     % %   %
%%%%% % % %%%%%%%%% %%%%%%%%%%% % %%%%%%%% % % %%%%%%%%% %%%%%%%%%%% % %%%
%   % %           % %     %   % %   %%   % %           % %     %   % %   %
% %%% %%%%% %%%%%%%%% %%%%% % % %%% %% %%% %%%%% %%%%%%%%% %%%%% % % %%% %
% %   %      %        %     %       %% %   %      %        %     %       %
% % % %%%%% %%% % % % % %%%%%%%%%%%%%% % % %%%%% %%% % % % % %%%%%%%%%%%%%
% % %   %     % % % %       %   % % %% % %   %     % % % %       %   % % %
% % %%% %%% % % % %%%%%%%%% %%% % % %% % %%% %%% % % % %%%%%%%%% %%% % % %
% %   % %   % % %   % %   % % %     %% %   % %   % % %   % %   % % %     %
% %%% %%% %%%%% %%% % % %%%%% % %%%%%% %%% %%% %%%%% %%% % % %%%%% % %%%%%
%       %   %     % %     %   % %   %%       %   %     % %     %   % %   %
%%% % %%%%% %%%%% %%% %%% % %%% % %%%%%% % %%%%% %%%%% %%% %%% % %%% % %%%
% % % % % % % %     % %   % %   % % %% % % % % % % %     % %   % %   % % %
% % %%% % % % % %%%%%%%%% % % % % % %% % %%% % % % % %%%%%%%%% % % % % % %
%   %   %   %                 %     %%   %   %   %                 %     %
% % % % %%% %%% %%%%%%% %%% %%% %%% %% % % % %%% %%% %%%%%%% %%% %%% %%% %
%P% % %       %   %       %   % %      % % %       %   %       %   % %   %
%%%%%%%%%%%%%%%%%%%%%%%%%%%%%%%%%%%%%%%%%%%%%%%%%%%%%%%%%%%%%%%%%%%%%%%% %
%%%%%%%%%%%%%%%%%%%%%%%%%%%%%%%%%%%%%%%%%%%%%%%%%%%%%%%%%%%%%%%%%%%%%%%% %
%       % % %           %   %     % %%       % % %           %   %     % %
% %%%%%%% % %%% % %%% %%% %%%%%%% % %% %%%%%%% % %%% % %%% %%% %%%%%%% % %
%       %       % %     %     % %   %%       %       % %     %     % %   %
%%%%% %%%%% %%% % % % %%% %%%%% % %%%%%%%% %%%%% %%% % % % %%% %%%%% % %%%
%   % % % %   % % % %   % %   % %   %%   % % % %   % % % %   % %   % %   %
% %%% % % % %%% %%%%% %%% % %%% %%% %% %%% % % % %%% %%%%% %%% % %%% %%% %
%       %     %   %   %     % % %   %%       %     %   %   %     % % %   %
%%% %%%%%%%%% %%%%%%% %%% %%% % % % %%%% %%%%%%%%% %%%%%%% %%% %%% % % % %
%             %       % %   %     % %%             %       % %   %     % %
% % %%%%% % %%% % % %%% % %%% %%% % %% % %%%%% % %%% % % %%% % %%% %%% % %
% % %     % % % % %     %   % % % % %% % %     % % % % %     %   % % % % %
% % % %%%%%%% % %%%%%%%%% %%% % %%% %% % % %%%%%%% % %%%%%%%%% %%% % %%% %
% % % %     %   %     %     %   %   %% % % %     %   %     %     %   %   %
%%% %%% % %%%%% %%%%% %%% %%% %%%%% %%%% %%% % %%%%% %%%%% %%% %%% %%%%% %
%     % % %     % %     % %   % % % %%     % % %     % %     % %   % % % %
% % % % % %%% %%% %%% %%% % % % % % %% % % % % %%% %%% %%% %%% % % % % % %
% % % % %                 % % %     %% % % % %                 % % %     %
%%% %%%%%%% % % %%%%% %%% % %%% %%%%%%%% %%%%%%% % % %%%%% %%% % %%% %%%%%
%       % % % %     %   %     % %   %%       % % % %     %   %     % %   %
%%%%% % % %%%%%%%%% %%%%%%%%%%% % %%%%%%%% % % %%%%%%%%% %%%%%%%%%%% % %%%
%   % %           % %     %   % %   %%   % %           % %     %   % %   %
% %%% %%%%% %%%%%%%%% %%%%% % % %%% %% %%% %%%%% %%%%%%%%% %%%%% % % %%% %
% %   %      %        %     %       %% %   %      %        %     %       %
% % % %%%%% %%% % % % % %%%%%%%%%%%%%% % % %%%%% %%% % % % % %%%%%%%%%%%%%
% % %   %     % % % %       %   % % %% % %   %     % % % %       %   % % %
% % %%% %%% % % % %%%%%%%%% %%% % % %% % %%% %%% % % % %%%%%%%%% %%% % % %
% %   % %   % % %   % %   % % %     %% %   % %   % % %   % %   % % %     %
% %%% %%% %%%%% %%% % % %%%%% % %%%%%% %%% %%% %%%%% %%% % % %%%%% % %%%%%
%       %   %     % %     %   % %   %%       %   %     % %     %   % %   %
%%% % %%%%% %%%%% %%% %%% % %%% % %%%%%% % %%%%% %%%%% %%% %%% % %%% % %%%
% % % % % % % %     % %   % %   % % %% % % % % % % %     % %   % %   % % %
% % %%% % % % % %%%%%%%%% % % % % % %% % %%% % % % % %%%%%%%%% % % % % % %
%   %   %   %                 %     %%   %   %   %                 %     %
% % % % %%% %%% %%%%%%% %%% %%% %%% %% % % % %%% %%% %%%%%%% %%% %%% %%% %
% % % %       %   %       %   % %      % % %       %   %       %   % %   %
% %%%%%%%%%%%%%%%%%%%%%%%%%%%%%%%%%%%%%%%%%%%%%%%%%%%%%%%%%%%%%%%%%%%%%%%%
%       % % %           %   %     % %%       % % %           %   %     % %
% %%%%%%% % %%% % %%% %%% %%%%%%% % %% %%%%%%% % %%% % %%% %%% %%%%%%% % %
%       %       % %     %     % %   %%       %       % %     %     % %   %
%%%%% %%%%% %%% % % % %%% %%%%% % %%%%%%%% %%%%% %%% % % % %%% %%%%% % %%%
%   % % % %   % % % %   % %   % %   %%   % % % %   % % % %   % %   % %   %
% %%% % % % %%% %%%%% %%% % %%% %%% %% %%% % % % %%% %%%%% %%% % %%% %%% %
%       %     %   %   %     % % %   %%       %     %   %   %     % % %   %
%%% %%%%%%%%% %%%%%%% %%% %%% % % % %%%% %%%%%%%%% %%%%%%% %%% %%% % % % %
%             %       % %   %     % %%             %       % %   %     % %
% % %%%%% % %%% % % %%% % %%% %%% % %% % %%%%% % %%% % % %%% % %%% %%% % %
% % %     % % % % %     %   % % % % %% % %     % % % % %     %   % % % % %
% % % %%%%%%% % %%%%%%%%% %%% % %%% %% % % %%%%%%% % %%%%%%%%% %%% % %%% %
% % % %     %   %     %     %   %   %% % % %     %   %     %     %   %   %
%%% %%% % %%%%% %%%%% %%% %%% %%%%% %%%% %%% % %%%%% %%%%% %%% %%% %%%%% %
%     % % %     % %     % %   % % % %%     % % %     % %     % %   % % % %
% % % % % %%% %%% %%% %%% % % % % % %% % % % % %%% %%% %%% %%% % % % % % %
% % % % %                 % % %     %% % % % %                 % % %     %
%%% %%%%%%% % % %%%%% %%% % %%% %%%%%%%% %%%%%%% % % %%%%% %%% % %%% %%%%%
%       % % % %     %   %     % %   %%       % % % %     %   %     % %   %
%%%%% % % %%%%%%%%% %%%%%%%%%%% % %%%%%%%% % % %%%%%%%%% %%%%%%%%%%% % %%%
%   % %           % %     %   % %   %%   % %           % %     %   % %   %
% %%% %%%%% %%%%%%%%% %%%%% % % %%% %% %%% %%%%% %%%%%%%%% %%%%% % % %%% %
% %   %      %        %     %       %% %   %      %        %     %       %
% % % %%%%% %%% % % % % %%%%%%%%%%%%%% % % %%%%% %%% % % % % %%%%%%%%%%%%%
% % %   %     % % % %       %   % % %% % %   %     % % % %       %   % % %
% % %%% %%% % % % %%%%%%%%% %%% % % %% % %%% %%% % % % %%%%%%%%% %%% % % %
% %   % %   % % %   % %   % % %     %% %   % %   % % %   % %   % % %     %
% %%% %%% %%%%% %%% % % %%%%% % %%%%%% %%% %%% %%%%% %%% % % %%%%% % %%%%%
%       %   %     % %     %   % %   %%       %   %     % %     %   % %   %
%%% % %%%%% %%%%% %%% %%% % %%% % %%%%%% % %%%%% %%%%% %%% %%% % %%% % %%%
% % % % % % % %     % %   % %   % % %% % % % % % % %     % %   % %   % % %
% % %%% % % % % %%%%%%%%% % % % % % %% % %%% % % % % %%%%%%%%% % % % % % %
%   %   %   %                 %     %%   %   %   %                 %     %
% % % % %%% %%% %%%%%%% %%% %%% %%% %% % % % %%% %%% %%%%%%% %%% %%% %%% %
% % % %       %   %       %   % %      % % %       %   %       %   % %   %
%%%%%%%%%%%%%%%%%%%%%%%%%%%%%%%%%%%%%%%%%%%%%%%%%%%%%%%%%%%%%%%%%%%%%%%% %
%%%%%%%%%%%%%%%%%%%%%%%%%%%%%%%%%%%%%%%%%%%%%%%%%%%%%%%%%%%%%%%%%%%%%%%% %
%       % % %           %   %     % %%       % % %           %   %     % %
% %%%%%%% % %%% % %%% %%% %%%%%%% % %% %%%%%%% % %%% % %%% %%% %%%%%%% % %
%       %       % %     %     % %   %%       %       % %     %     % %   %
%%%%% %%%%% %%% % % % %%% %%%%% % %%%%%%%% %%%%% %%% % % % %%% %%%%% % %%%
%   % % % %   % % % %   % %   % %   %%   % % % %   % % % %   % %   % %   %
% %%% % % % %%% %%%%% %%% % %%% %%% %% %%% % % % %%% %%%%% %%% % %%% %%% %
%       %     %   %   %     % % %   %%       %     %   %   %     % % %   %
%%% %%%%%%%%% %%%%%%% %%% %%% % % % %%%% %%%%%%%%% %%%%%%% %%% %%% % % % %
%             %       % %   %     % %%             %       % %   %     % %
% % %%%%% % %%% % % %%% % %%% %%% % %% % %%%%% % %%% % % %%% % %%% %%% % %
% % %     % % % % %     %   % % % % %% % %     % % % % %     %   % % % % %
% % % %%%%%%% % %%%%%%%%% %%% % %%% %% % % %%%%%%% % %%%%%%%%% %%% % %%% %
% % % %     %   %     %     %   %   %% % % %     %   %     %     %   %   %
%%% %%% % %%%%% %%%%% %%% %%% %%%%% %%%% %%% % %%%%% %%%%% %%% %%% %%%%% %
%     % % %     % %     % %   % % % %%     % % %     % %     % %   % % % %
% % % % % %%% %%% %%% %%% % % % % % %% % % % % %%% %%% %%% %%% % % % % % %
% % % % %                 % % %     %% % % % %                 % % %     %
%%% %%%%%%% % % %%%%% %%% % %%% %%%%%%%% %%%%%%% % % %%%%% %%% % %%% %%%%%
%       % % % %     %   %     % %   %%       % % % %     %   %     % %   %
%%%%% % % %%%%%%%%% %%%%%%%%%%% % %%%%%%%% % % %%%%%%%%% %%%%%%%%%%% % %%%
%   % %           % %     %   % %   %%   % %           % %     %   % %   %
% %%% %%%%% %%%%%%%%% %%%%% % % %%% %% %%% %%%%% %%%%%%%%% %%%%% % % %%% %
% %   %      %        %     %       %% %   %      %        %     %       %
% % % %%%%% %%% % % % % %%%%%%%%%%%%%% % % %%%%% %%% % % % % %%%%%%%%%%%%%
% % %   %     % % % %       %   % % %% % %   %     % % % %       %   % % %
% % %%% %%% % % % %%%%%%%%% %%% % % %% % %%% %%% % % % %%%%%%%%% %%% % % %
% %   % %   % % %   % %   % % %     %% %   % %   % % %   % %   % % %     %
% %%% %%% %%%%% %%% % % %%%%% % %%%%%% %%% %%% %%%%% %%% % % %%%%% % %%%%%
%       %   %     % %     %   % %   %%       %   %     % %     %   % %   %
%%% % %%%%% %%%%% %%% %%% % %%% % %%%%%% % %%%%% %%%%% %%% %%% % %%% % %%%
% % % % % % % %     % %   % %   % % %% % % % % % % %     % %   % %   % % %
% % %%% % % % % %%%%%%%%% % % % % % %% % %%% % % % % %%%%%%%%% % % % % % %
%   %   %   %                 %     %%   %   %   %                 %     %
% % % % %%% %%% %%%%%%% %%% %%% %%% %% % % % %%% %%% %%%%%%% %%% %%% %%% %
%.% % %       %   %       %   % %      % % %       %   %       %   % %   %
%%%%%%%%%%%%%%%%%%%%%%%%%%%%%%%%%%%%%%%%%%%%%%%%%%%%%%%%%%%%%%%%%%%%%%%%%%
