%%%%%%%%%%%%
%          %
%   %%%%%% %
%       P% %
%   %%%%%% %
%   %    % %
%   %    % %
%        % %
%        % %
%        %.%
%        % %
%%%%%%%%%%%%
